

NO ./textures/redbrick.xpm

SO    ./textures/cloud0.xpm

S ./textures/cat.xpm

WE ./textures/mossy.xpm
EA    ./textures/grass_and_dirt.xpm


C 255,154,0
F              255,219,0
R 1200 800


1111111111111111111111111111111111111111111111111111111111111111111111
1000000000000000000000010000011110000000000000000000000000000000000001
1011000000000000000000010000011100000000000000000000000100000000000001
1001000000000001000000000001000000000001010000000100000000000000200001
10100000100000000000000000010000000020001010000000000000000000000000001
1000000000000000000100020010000000000000000000000000000000000000000000111111
11110000000000000000000000000000000100000021000000000000000000000000000000001
11101000000010010001010000000000200000000W000000000000000011000000000000000001
110000001100000000000000000000000000000000000000001000000001100020000000000001
1000000000000000000000020000100000000000000000000000000000001100000000000000001
100000000000000000000000000010000001000000000100000000000000011000000001000001
11000000000001000000000000111000000000000000011000000000000000000000000000000111
100000010000000000000000000011000000000000000110000000000000000000000000000000001
100000010000100000000000000011000000001000000000000000011100000000000000000000001
100000011111000000000000000010000000000110000100000111111100000000000001000000001
1000000000000000001000000000110000000000000111000110000001000000100000000000000001
100000000000000000000000000000001000000020000000010000000100000000000000000000001
100000001000000000000011000000001001000000000000010000000100000100000000000000001
11111111111111111111111111111111111111111111111111111111111111111111111111111111111111111
